1111111111111111111111
1PCCC00CCCE1C111111111
1111111111111111111111