1111111111111111111111
1PCCC00CCCE11111111111
1111111111111111111111