1111111111111111111111111111111
1P0000010000001C0000100000000E1
100000C10000001000001C000000001
1000111100000011100011110000001
1000000000000010000010000010001
1000000000C0001000001W000010C01
1000000000000000000010000011111
100000000000111W000010000000001
1111111110001C00000010000000001
1000001000001110000000000000001
10C00010W0000010010000000010001
100000100000001001C000000010001
1W00001000001111111111111110001
1000000000000000000010C00000001
1111000000000000000010000000001
10000000111100W0000010000000001
1000000010C00000000000011110001
100C000010000000100000010000001
100000001000000010000001C000001
1111111111111111111111111111111