1111111111111111111111111111111
1P0000010000001C000010000000011
100000C10000001000001C000000001
1000111100000011100011110000001
1000000000000010000010000010001
1000000000C00010000010000010C01
1000000000000010000010000011111
1000000000001110000010000000001
1111111110001C00000010000000001
1000001000001110000000000000001
10C0001000000010001100000010001
1000001000000010001C00000010001
1000001000001111111111111110001
1000000000000000000010C00000001
1111000000000000000010000000001
1000000011110E00000010000000001
1000000010C00000000000011100111
100C00001000000010C000010000101
100000001000000010000001C01WC11
1111111111111111111111111111111